102
60,3,200,150,-50,-200,-150,-50,-500,-150,900,500,150,400
10,3,200,150,-50,-200,-150,-50,-500,-150,900,500,150,400
10,3,200,150,-50,-200,-150,-50,-500,-150,900,500,150,400
10,3,200,150,-50,-200,-150,-50,-500,-150,900,500,150,400
10,3,200,150,-50,-200,-150,-50,-500,-150,900,500,150,400
10,3,200,150,-50,-200,-150,-50,-500,-150,900,500,150,400
10,3,200,150,-50,-200,-150,-50,-500,-150,900,500,150,400
10,3,200,150,-50,-200,-150,-50,-500,-150,900,500,150,400
10,3,200,150,-50,-200,-150,-50,-500,-150,900,500,150,400
10,3,200,150,-50,-200,-150,-50,-500,-150,900,500,150,400
60,3,-200,-150,-50,200,150,-50,500,150,900,-500,-150,400
10,3,-200,-150,-50,200,150,-50,500,150,900,-500,-150,400
10,3,-200,-150,-50,200,150,-50,500,150,900,-500,-150,400
10,3,-200,-150,-50,200,150,-50,500,150,900,-500,-150,400
10,3,-200,-150,-50,200,150,-50,500,150,900,-500,-150,400
10,3,-200,-150,-50,200,150,-50,500,150,900,-500,-150,400
10,3,-200,-150,-50,200,150,-50,500,150,900,-500,-150,400
10,3,-200,-150,-50,200,150,-50,500,150,900,-500,-150,400
10,3,-200,-150,-50,200,150,-50,500,150,900,-500,-150,400
10,3,-200,-150,-50,200,150,-50,500,150,900,-500,-150,400
120,99,0,0,-200,0,0,500,0,0,0,0,0,0
120,0,-200,100,-100,-200,100,500,0,0,0,0,0,0
15,0,-100,100,-100,-100,100,500,0,0,0,0,0,0
15,0,0,100,-100,0,100,500,0,0,0,0,0,0
15,0,100,100,-100,100,100,500,0,0,0,0,0,0
15,0,200,100,-100,200,100,500,0,0,0,0,0,0
30,0,200,-100,-100,200,-100,500,0,0,0,0,0,0
15,0,100,-100,-100,100,-100,500,0,0,0,0,0,0
15,0,0,-100,-100,0,-100,500,0,0,0,0,0,0
15,0,-100,-100,-100,-100,-100,500,0,0,0,0,0,0
15,0,-200,-100,-100,-200,-100,500,0,0,0,0,0,0
180,999,1,0,0,0,0,0,0,0,0,0,0,0
60,0,0,200,-100,0,100,500,0,0,0,0,0,0
10,0,100,173.2,-100,50,86.6,500,0,0,0,0,0,0
10,0,173.2,100,-100,86.6,50,500,0,0,0,0,0,0
10,0,200,0,-100,100,0,500,0,0,0,0,0,0
10,0,173.2,-100,-100,86.6,-50,500,0,0,0,0,0,0
10,0,100,-173.2,-100,50,-86.6,500,0,0,0,0,0,0
10,0,0,-200,-100,0,-100,500,0,0,0,0,0,0
10,0,-100,-173.2,-100,-50,-86.6,500,0,0,0,0,0,0
10,0,-173.2,-100,-100,-86.6,-50,500,0,0,0,0,0,0
10,0,-200,0,-100,-100,0,500,0,0,0,0,0,0
10,0,-173.2,100,-100,-86.6,50,500,0,0,0,0,0,0
10,0,-100,173.2,-100,-50,86.6,500,0,0,0,0,0,0
180,1,120,60,-200,60,30,600,0,0,0,0,0,0
5,1,120,60,-200,10,80,650,0,0,0,0,0,0
5,1,120,60,-200,110,80,550,0,0,0,0,0,0
5,1,120,60,-200,160,130,650,0,0,0,0,0,0
5,1,120,60,-200,-40,130,550,0,0,0,0,0,0
60,1,-120,-60,-200,-60,-30,600,0,0,0,0,0,0
5,1,-120,-60,-200,-10,-80,650,0,0,0,0,0,0
5,1,-120,-60,-200,-110,-80,550,0,0,0,0,0,0
5,1,-120,-60,-200,-160,-130,650,0,0,0,0,0,0
5,1,-120,-60,-200,40,-130,550,0,0,0,0,0,0
180,2,-200,100,-100,-200,100,600,0,0,0,0,0,0
0,2,-150,100,-100,-150,100,600,0,0,0,0,0,0
0,2,-100,100,-100,-100,100,600,0,0,0,0,0,0
0,2,-50,100,-100,-50,100,600,0,0,0,0,0,0
0,2,-200,50,-100,-200,50,600,0,0,0,0,0,0
0,2,-150,50,-100,-150,50,600,0,0,0,0,0,0
0,2,-100,50,-100,-100,50,600,0,0,0,0,0,0
0,2,-50,50,-100,-50,50,600,0,0,0,0,0,0
0,2,-200,0,-100,-200,0,600,0,0,0,0,0,0
0,2,-150,0,-100,-150,0,600,0,0,0,0,0,0
0,2,-100,0,-100,-100,0,600,0,0,0,0,0,0
0,2,-50,0,-100,-50,0,600,0,0,0,0,0,0
60,2,200,-100,-100,200,-100,600,0,0,0,0,0,0
0,2,150,-100,-100,150,-100,600,0,0,0,0,0,0
0,2,100,-100,-100,100,-100,600,0,0,0,0,0,0
0,2,50,-100,-100,50,-100,600,0,0,0,0,0,0
0,2,200,-50,-100,200,-50,600,0,0,0,0,0,0
0,2,150,-50,-100,150,-50,600,0,0,0,0,0,0
0,2,100,-50,-100,100,-50,600,0,0,0,0,0,0
0,2,50,-50,-100,50,-50,600,0,0,0,0,0,0
0,2,200,0,-100,200,0,600,0,0,0,0,0,0
0,2,150,0,-100,150,0,600,0,0,0,0,0,0
0,2,100,0,-100,100,0,600,0,0,0,0,0,0
0,2,50,0,-100,50,0,600,0,0,0,0,0,0
60,2,200,100,-100,200,100,600,0,0,0,0,0,0
0,2,150,100,-100,150,100,600,0,0,0,0,0,0
0,2,100,100,-100,100,100,600,0,0,0,0,0,0
0,2,50,100,-100,50,100,600,0,0,0,0,0,0
0,2,200,50,-100,200,50,600,0,0,0,0,0,0
0,2,150,50,-100,150,50,600,0,0,0,0,0,0
0,2,100,50,-100,100,50,600,0,0,0,0,0,0
0,2,50,50,-100,50,50,600,0,0,0,0,0,0
0,2,200,0,-100,200,0,600,0,0,0,0,0,0
0,2,150,0,-100,150,0,600,0,0,0,0,0,0
0,2,100,0,-100,100,0,600,0,0,0,0,0,0
0,2,50,0,-100,50,0,600,0,0,0,0,0,0
60,2,-200,-100,-100,-200,-100,600,0,0,0,0,0,0
0,2,-150,-100,-100,-150,-100,600,0,0,0,0,0,0
0,2,-100,-100,-100,-100,-100,600,0,0,0,0,0,0
0,2,-50,-100,-100,-50,-100,600,0,0,0,0,0,0
0,2,-200,-50,-100,-200,-50,600,0,0,0,0,0,0
0,2,-150,-50,-100,-150,-50,600,0,0,0,0,0,0
0,2,-100,-50,-100,-100,-50,600,0,0,0,0,0,0
0,2,-50,-50,-100,-50,-50,600,0,0,0,0,0,0
0,2,-200,0,-100,-200,0,600,0,0,0,0,0,0
0,2,-150,0,-100,-150,0,600,0,0,0,0,0,0
0,2,-100,0,-100,-100,0,600,0,0,0,0,0,0
0,2,-50,0,-100,-50,0,600,0,0,0,0,0,0

