37
60,3,-200,200,-100,200,-100,-600,0,0,500,0,0,500
10,3,-200,200,-100,200,-100,-600,0,0,500,0,0,500
10,3,-200,200,-100,200,-100,-600,0,0,500,0,0,500
10,3,-200,200,-100,200,-100,-600,0,0,500,0,0,500
10,3,-200,200,-100,200,-100,-600,0,0,500,0,0,500
10,3,-200,200,-100,200,-100,-600,0,0,500,0,0,500
10,3,-200,200,-100,200,-100,-600,0,0,500,0,0,500
10,3,-200,200,-100,200,-100,-600,0,0,500,0,0,500
10,3,-200,200,-100,200,-100,-600,0,0,500,0,0,500
60,3,-200,-200,-100,-200,200,-600,0,100,500,0,100,500
10,3,-200,-200,-100,-200,200,-600,0,100,500,0,100,500
10,3,-200,-200,-100,-200,200,-600,0,100,500,0,100,500
10,3,-200,-200,-100,-200,200,-600,0,100,500,0,100,500
10,3,-200,-200,-100,-200,200,-600,0,100,500,0,100,500
10,3,-200,-200,-100,-200,200,-600,0,100,500,0,100,500
10,3,-200,-200,-100,-200,200,-600,0,100,500,0,100,500
10,3,-200,-200,-100,-200,200,-600,0,100,500,0,100,500
10,3,-200,-200,-100,-200,200,-600,0,100,500,0,100,500
10,3,-200,-200,-100,-200,200,-600,0,100,500,0,100,500
120,0,-200,150,800,0,120,100,0,0,0,0,0,0
0,0,-200,0,800,0,0,100,0,0,0,0,0,0
0,0,-200,-150,800,0,-120,100,0,0,0,0,0,0
0,0,-200,0,800,-120,0,100,0,0,0,0,0,0
0,0,-200,0,800,120,0,100,0,0,0,0,0,0
240,1,-200,-300,150,-200,-100,150,0,0,0,0,0,0
10,1,-200,-300,150,-150,-50,150,0,0,0,0,0,0
10,1,-200,-300,150,-250,-150,150,0,0,0,0,0,0
90,1,0,300,200,0,100,200,0,0,0,0,0,0
10,1,0,300,200,50,50,200,0,0,0,0,0,0
10,1,0,300,200,-50,150,200,0,0,0,0,0,0
90,1,-50,-300,250,-50,-100,250,0,0,0,0,0,0
10,1,-50,-300,250,-100,-50,250,0,0,0,0,0,0
10,1,-50,-300,250,-150,-150,250,0,0,0,0,0,0
90,1,-250,300,300,-250,100,300,0,0,0,0,0,0
10,1,-250,300,300,-200,50,300,0,0,0,0,0,0
10,1,-250,300,300,-150,0,300,0,0,0,0,0,0
120,999,0,0,0,0,0,0,0,0,0,0,0,0

